     NO ./texturs/north.xpm




        SO ./texturs/south.xpm
                  


        EA ./texturs/east.xpm




    WE ./texturs/west.xpm

            F 220,100,0
    C 225,30,0
111111
100001
10N000
111111
 
lsdkfj
sdlkfjsldfkjsldkfjsldkfj
sdlkfjlsdkfj